#domain
hospital
#levelname
MAPF03
#colors
blue: 0,1,2,3
#initial
+++++++++++++
+     1     +
+        ++++
+0          +
+3    2  ++ +
+         + +
+++++++++++++
#goal
+++++++++++++
+2         3+
+        ++++
+           +
+        ++ +
+1        +0+
+++++++++++++
#end
